16 16
7 6 10 10 10 10 10 10 10 10 2 10 3 6 2 3 
5 5 14 3 6 10 10 10 3 6 9 7 5 13 5 5 
5 12 10 9 5 7 6 3 5 12 3 5 12 10 9 5 
12 10 10 10 9 5 5 5 12 10 9 12 2 2 11 5 
3 6 10 2 3 4 9 12 2 10 10 3 13 12 3 4 
12 9 6 9 5 5 14 3 12 10 3 12 10 10 9 5 
6 10 9 14 9 12 3 4 2 11 12 10 10 10 10 9 
4 10 3 6 10 3 5 5 12 10 3 6 10 2 3 7 
12 11 5 12 3 12 9 13 6 3 5 12 3 5 12 1 
6 2 8 11 12 10 10 10 9 5 4 3 5 12 3 5 
5 13 6 3 6 2 2 10 11 5 13 12 9 6 9 5 
5 6 9 12 9 5 13 6 10 9 6 3 6 9 6 9 
4 9 6 10 10 1 6 9 6 10 9 12 9 7 12 3 
12 3 12 10 3 13 5 6 9 14 2 10 10 1 6 9 
7 5 6 3 12 3 12 9 6 2 9 14 10 9 12 3 
12 8 9 12 11 12 10 10 9 12 10 10 10 10 10 9 
